#####
#   #
#####
#   #
### #
#   #
# ###
#   #
#####
#   #
#####